11 7
...T.......
....T......
..TTTTTTT..
r>>>v.>>>>x
...T>>^T...
....TTT....
........TT.
3 6000
2 0 0
1 2 0
1 0 2